-@@@@@@@@@@@@@@@@-@@-@@@@@-@@@@@
@@@@@@@@@@@@@@@@@@-@@-@@@@@-@@@@
@-@@@@@-@-@@@@@@@@-@@@-@@@@@-@@M
@@@@@@-@@@-@@@@@@-@@@@@-@@@@@-@@
@@@@@-@@@@@-@@@@-@@@@@@@-@@@@@-@
@@@@-@@@@@@@-@@-@@@@@@@@@@@@@@@@
@-#-@@@@@@@@@--@@@@@@@@@@@@@@@@@
@@-@@@@@@@@@@--@@@@@@@@@@G@@@@-@
@@@-@@@@@@@@-@@@@@@@---------@@-
--@@-@@@@@@@@@@@@@@@@@@@@@@@@@@-
@@@@-@@@@@@--@@@@@@@@@@@@@@@-@@-
@@@-@@@@@--@@@@@@@-@-@@@@@@-@@@-
-@-@@-@@@@@@@@@@@-@-@-@@@@-@@@@-
@-@@@@-@@-@@@@@@-@@-@@-@@-@@@@@-
@@-@@@@-@@@@@@@-@@@-@@@--@-@@@@-
@-@-@@@@@@@@@@-@-@@-@@@-@@@-@@@-
@@-@@@@@-@@@@@@@@-@@-@-@@@@@-@@-
@@@-@@-@@-@@@@-@@@-@@-@@@@@@@@@-
@--@@@@@@@-@@@@-@@@-@@-@-@@@@@@-
@@@-@@@@@-@-@@@@-@@@--@-@--@-@-@
@@@@@@@@-@@@-@@@@-@@@@@@@@@@@@@@
@B--@@@@@@@-@@@@-@@@-@@-@-@@@@@@
